NO textures/nor.xpm
SO textures/sou.xpm
EA textures/eas.xpm
WE textures/wes.xpm

F 176,196,222
C 192,192,192




1111111111111111111111111     1      111
100S000000110000000000001     1      101
1010000001110000000000011     1      111
100100000000000000000000111111111
111111111011000001110000000000001
100000000011000001110111111111111
11110111111111011100000010001
11110111111111011101010010001
11000000110101011100000010001
10000000000000001100000010001
10000000000000001101010010001
1101011111010101111101111000111
11110001 1110101 101111010001
11111111 1111111 111111111111
1
111
101
111 