NO textures/nor.xpm
SO textures/sou.xpm
EA textures/eas.xpm
WE textures/wes.xpm

F 118,78,50
C 192,192,192




11111111111111111111111111111111111111111111111111111111111111111111111111111 111111
11000000000000000000000000000011000000000000000000000000000000000000000000001 110001
11000000000000000001100000000000000000000000000000000000000000000000000000001 1000N1
11000000000000000001100000000011000000000000000000000000000000000111110000001 111111
11000000000000000001100001100000000000000011111000000000000000000000000000001
11000000000000000001100001100000000000000000000000000000000000011111111111111
1100000000000000000000000110000000001111110000000000000111111111
11000000000000000000000001100000000011000000000000000001
11000000000000000000000000000000000111110000000000000111
1100000000000000000000000000000000001100000000000000001
1111111111111111111111111111111111111111111111111111111